00000000000000000000000000000000000000000000000000000000000000000000
00000000000000000000000000000000000000000000000000000000000000000000
00000000000000000000000000000000000000000000000000000000000000000000
00000000000000000000000000000000000000000000000000000000000000000000
00000000000000000000000000000000000000000000000000000000000000000000
00000000000000000000000000000000000000000000000000000000000000000000
1111d00000000000000001115d000000000000000000000d11111101111000000000
00004000000000000000011114000000000000000000000411111101111000000000
00004000000000000000000004000000000000000000000400000000000000000000
00004000000000011111000004000000000000000000000400000000000000000000
00004000000000011111000004000000000000000000000400000000000000000000
00004000000000000000000004000000000000000000000400000000000000000000
0000400000011171000000000411117101111011511000040000000001111111s118
0000400000011111000000000u111111011110111110000400000000011111111111
0000u111110000000000000000000000000000000001111u00000000000000000000
00000000000000000000000000000000000000000000000000000000000000000000
99999999999999999999999999999999999999999999999999999999999999999999