00000000000000000000000000000000000000000000000000000000000000000000
00000000000000000000000000000000000000000000000000000000000000000000
00000000000000000000000000000000000000000000000000000000000000000000
00000000000000000000000000000000000000000000000000000000000000000000
00000000006000000000000000000000000000006000000000000000060000000000
00000000000000000000000000000000000000000000000000000000000000000000
0000000000000000011117111d00000d1110000000000000000000000000000d1118
00000000000000000111111114000004000000000000000000000000000000040000
00000000000000000000000004000004000000000000000000000000000000040000
00000000000000000000000004000004000000000000000000000000000000040000
11110000000011111100000004000004000111711110000000000000000000040000
00000000000011111100000004000004000111111110000000000000000000040000
00000000000000000000000004000004000000000000000000000000000000040000
00000000000000000000000004000004000000000000000000000000000000040000
0001111115111100000000000u11151u100000000001111110000000001111140000
000111111111110000000000000000000000000000011111111710117111111u0000
99999999999999999999999999999999999999999999999999999999999999999999