640000801
500700020
270490000
036518090
000302000
050967140
000074086
080009002
701000059
